111111111111111111111111111111111111111111111111111111111111111
100000000000000C00000C00000000000000000000110000100000000000001
101001010010000010100100000001010000000000000000000000010000001
1010010010101010001001000000010100000000001100000000000C0000001
1P0000000C00C0000000000000000000C00000000000000000000CCC0000001
100000000000000C00000C00000000000C000C0000001110000000000000001
101001010010000010100100000001010000000000000000000000000000001
1010010010101010001001000000010100000000010000000C00000C0000001
110000000C00C0000000000000000000C000000000100000000000000000001
100000000000000C00000C00000000000000CC000010000C00C000000000001
101001010010000010100100000001010000000000010000001000000000001
101001001010101000100100000001010000000000000000000E00000000001
100000000C00C0000000000000000000C000000000000001100000011000001
111111111111111111111111111111111111111111111111111111111111111
